NO ./assets/no.png
WE ./assets/we.png
SO ./assets/so.png
EA ./assets/ea.png
F 66, 110, 65
C 142, 191, 187
DO ./assets/door.png


11111111111111111111
1DDDDDDDDDDDDDDDDDD1
1D0000000000000000D1
1D0000000000000000D1
1D0000000000000000D1
1D0000000N00000000D1
1D0000000000000000D1
1D0000000000000000D1
1DDDDDDDDDDDDDDDDDD1
11111111111111111111
