NO ./assets/no.png
WE ./assets/we.png
SO ./assets/so.png
EA ./assets/ea.png
F 66, 110, 65
C 142, 191, 187
DO ./assets/door.png


11111111111111111111
1    D000000000D   1
1    D000000000D   1
1    D000000000D   1
11111D0000N0000D1111
    1D000000000D1
11111D000000000D1111
1    D000000000D   1
1    DDDDDDDDDDD   1
11111111111111111111
