NO ./src/textures/bamboo.png
WE ./src/textures/log.png
SO ./src/textures/quartz.png
EA ./src/textures/stone.png
F 110,130,110
C 150,170,255

111111111111111111111111111
100000000000000000000000001
100000001111000000000000001
100000001  1000000000000001
100000000000000000000000001
100000000000000000000000001
100000000000000000000000001
100000000000000000000000001
100000000011000000000000001
100000000011000000000000001
1N0000000011000000000000001
100000000011000000000000001
100000000000000000000000001
100000000000000000000000001
100000000000000000000000001
111111111111111111111111111
