NO ./src/textures/Tile_11.png
WE ./src/textures/Tile_06.png
SO ./src/textures/Tile_08.png
EA ./src/textures/Stone_03.png
F 110,130,110
C 150,170,255

111111111111111111111111111
100000000000000000000000001
100000000000000000000000001
100000000000000000000000001
100000000000000000000000001
100000000000000000000000001
100000000000000000000000001
100000000000011000000000001
100000000000011000000000001
100000000000000000000000001
100000000000000000000000001
100000000000000000000000001
100000000000000000000110001
100011000000000000000000001
100000110000000000000000001
100000000000000000000000001
100000000000000000000000001
100000000000000000000000001
100000000000000000000000001
100000000000001111100000001
100000000000000000000000001
100000000000000000000000001
10N000000000000000000000001
111111111111111111111111111
