NO ./assets/textures/Bark.png
SO ./assets/textures/bookshelf.png
WE ./assets/textures/Bricks.png
EA ./assets/textures/Coal.png
F 0,255,0
C 0,0,255
1111111111111111111111111
1000000000110000000000001
101100000111000000N000001
1001000000000000000000001
111111111011111111110000100000001
100000000011000001111111111111111
11110111111111011100000010001
11110111111111011101010010001
11000000110101011100000010001
10000000000000001100000000001
10000000000000001101010000001
1100000111010101111101110000111
11110111 1110101 101111010001
11111111 1111111 111111111111


