NO./assets/no.png
WE./assets/we.png
SO./assets/so.png
EA./assets/ea.png

F +66,110,65
C +142,191,187

111111111
1000N0001
111111111
