NO ./assets/no
WE ./assets/we
SO ./assets/so
EA ./assets/ea

111111111
1000N0001
111111111
