111111111
1000N0001
111111111

NO ./assets/no
WE ./assets/we
SO ./assets/so
EA ./assets/ea

F 255,100,20
C 200,8,8
