NO ./assets/no
WE ./assets/we
SO ./assets/so
EA ./assets/ea

F 255,100,20
C 200,8,8

111111111
1		1
1	N0001
1		1
111111111
