NO ./assets/no
WE ./assets/we
SO ./assets/so
EA ./assets/ea
F 255,0,0
C 200,8,8

1111111111
1N           
1111111111
