NO ./assets/no.png
WE ./assets/we.png
SO ./assets/so.png
EA ./assets/ea.png
F 255,0,0

111111111
1000N0001
111111111


X 200,8,8
