NO ./assets/no
WE ./assets/we
SO ./assets/so
EA ./assets/ea
F 255,0,0
C 200,8,8

111111111
10N00S001
111111111
