NO ./assets/no.png
WE ./assets/we.png
SO ./assets/so.png
EA ./assets/ea.png
F 66, 110, 65
C 142, 191, 187


    11111111111111111
    10000010S00000001
    100000D0000000001
    11111111111111111




DO ./assets/door.png
