NO ./assets/
WE ./assets/we
SO ./assets/so
EA ./assets/ea
F 255,0,0
C 200,8,8

111111111
1000000N1
100000001
100000001
111111111
