NO ./assets/no
WE ./assets/we
SO ./assets/so
EA ./assets/ea

F 255,100,20
C 200,8,8

1111111111
1000N00001
10000000001
 10000000001
  111111111
			
			
			
11111111111
10 0 0 0 01
00000000000

