NO ./assets/no.png
WE ./assets/we.png
SO ./assets/so.png
EA ./assets/ea.png
F 66, 110, 65
C 142, 191, 187
DO ./assets/door.png



    11111111111111111
    10000000S00000001
    1$$000$000$000$$1
    1$$     0     $$1
    1       0       1
    1       0       1
    1$     $0$     $1
    1111D111D111D1111
    1$0000000000000$1
    11111111111111111
