F 245,245,220
C 255,223,0

NO ./assets/textures/cat1.png
SO ./assets/textures/cat2.png
WE ./assets/textures/cat3.png
EA ./assets/textures/cat4.png

1111111111111111111111111
1000000000110000000000001
1011000001110000000000001
1001000000000000000000001
111111111011111111110000100000001
100000000011000001111111111111111
11110111111111011100000010001
11110111111111011101010010001
11000000110101011100000010001
10000000000000001100000000001
10000000000000001101010000001
110000011101010111110111000O111
11110111 1110101 101111010001
11111111 1111111 111111111111
